1111111111111111111111111111111111
1000C000000000000000000000000C0001
10100101001000001010010000C0010101
101001001011010100100100E000010101
100000000C000000000000111111110001
1000000000001110000100100CP0010001
10011100000C0000000100100000010001
1000000000000111000111111111110001
100000000C000000000000C00000000001
1111111111111111111111111111111111